#S#############
#.......#.....#
#.###.#.#.#.###
#.#.#.#.#.#...#
#.#.#.#.#.###.#
#.#.#.#.#...#.#
#.#.#.#####.#.#
#...#.#.....#.#
###.#.#.#######
#...#.#.#.#...#
#.###.#.#.#.#.#
#.#.#...#...#.#
#.#.#########.#
#.............#
#############G#
